******************************
******************************
******************************
******------******************
******//////******************
******//////******************
******************************
******************************
******************************
******************************