+***+***+***+***+***+***+***
**+***+***+***+//*+***+***+*
+***+//*+***+***+***+***+***
+***+***"0(-+***+*//+***+***
**+***+*9.&)**+***+***+***+*
+***+//*5678+***"0(-+***+//*
+***+//*1234+***9.&)+***+//*
+***+//*+***+***5678*+***+//
+***+//*+***+***1234+***+//*
+***+//*+***+***+***+***+//*
