+***+***+***+***+***+***+***+*+***+***+***+***+***+***+***+*
**+***+***+***+***+***+***+***+***+***+***+***+***+***+***+*
+***+//*+***+***+***+***+***+*+***+***+***+***+***+***+***+*
+***+***+***+***+***+***+***+*+***+***+***+***+***+***+***+*
**+***+***+***+***+***+***+***+***+***+***+***+***+***+***+*
+***+//*+***+***+***+***+***+*+***+***+***+***+***+***+***+*
